,color,next_play,balance,bet_amount
0,red,red,175000,10
1,black,black,174990,20
2,red,red,174970,40
3,red,red,175010,10
4,black,black,175000,20
5,black,black,175020,10
6,black,black,175030,10
7,red,red,175020,20
8,black,black,175000,40
9,black,black,175040,10
10,red,red,175030,20
11,red,red,175050,10
12,black,black,175040,20
13,red,red,175020,40
14,red,red,175060,10
15,black,black,175050,20
16,black,black,175070,10
17,black,black,175080,10
18,red,red,175070,20
19,black,black,175050,40
20,red,red,175010,80
21,red,red,175090,10
22,red,red,175100,10
23,black,black,175090,20
24,black,black,175110,10
25,red,red,175100,20
26,red,red,175120,10
27,red,red,175130,10
28,red,red,175140,10
29,red,red,175150,10
30,red,red,175160,10
31,black,black,175150,20
32,black,black,175170,10
33,black,black,175180,10
34,red,red,175170,20
35,black,black,175150,40
36,black,black,175190,10
37,black,black,175200,10
38,red,red,175190,20
39,black,black,175170,40
40,red,red,175130,80
41,black,black,175050,160
42,red,red,174890,320
43,red,red,175210,10
44,black,black,175200,20
45,red,red,175180,40
46,black,black,175140,80
47,black,black,175220,10
48,black,black,175230,10
49,black,black,175240,10
50,red,red,175230,20
51,black,black,175210,40
52,red,red,175170,80
53,red,red,175250,10
54,black,black,175240,20
55,black,black,175260,10
56,red,red,175250,20
57,black,black,175230,40
58,black,black,175270,10
59,black,black,175280,10
60,black,black,175290,10
61,red,red,175280,20
62,black,black,175260,40
63,black,black,175300,10
64,red,red,175290,20
65,red,red,175310,10
66,red,red,175320,10
67,black,black,175310,20
68,black,black,175330,10
69,red,red,175320,20
70,red,red,175340,10
71,black,black,175330,20
72,black,black,175350,10
73,red,red,175340,20
74,black,black,175320,40
75,red,red,175280,80
76,black,black,175200,160
77,black,black,175360,10
78,red,red,175350,20
79,black,black,175330,40
80,red,red,175290,80
81,black,black,175210,160
82,black,black,175370,10
83,black,black,175380,10
84,red,red,175370,20
85,red,red,175390,10
86,red,red,175400,10
87,red,red,175410,10
88,black,black,175400,20
89,black,black,175420,10
90,red,red,175410,20
91,red,red,175430,10
92,black,black,175420,20
93,red,red,175400,40
94,red,red,175440,10
95,red,red,175450,10
96,black,black,175440,20
97,black,black,175460,10
98,red,red,175450,20
99,black,black,175430,40
100,red,red,175390,80
101,black,black,175310,160
102,red,red,175150,320
103,black,black,174830,640
104,black,black,175470,10
105,red,red,175460,20
106,black,black,175440,40
107,black,black,175480,10
108,red,red,175470,20
109,black,black,175450,40
110,black,black,175490,10
111,black,black,175500,10
112,black,black,175510,10
113,black,black,175520,10
114,red,red,175510,20
115,red,red,175530,10
116,red,red,175540,10
117,black,black,175530,20
118,red,red,175510,40
119,red,red,175550,10
120,black,black,175540,20
121,black,black,175560,10
122,red,red,175550,20
123,red,red,175570,10
124,red,red,175580,10
125,black,black,175570,20
126,red,red,175550,40
127,black,black,175510,80
128,red,red,175430,160
129,black,black,175270,320
130,red,red,174950,640
131,red,red,175590,10
132,red,red,175600,10
133,red,red,175610,10
134,red,red,175620,10
135,red,red,175630,10
136,red,red,175640,10
137,red,red,175650,10
138,black,black,175640,20
139,black,black,175660,10
140,red,red,175650,20
141,red,red,175670,10
142,red,red,175680,10
143,red,red,175690,10
144,black,black,175680,20
145,black,black,175700,10
146,black,black,175710,10
147,black,black,175720,10
148,red,red,175710,20
149,black,black,175690,40
150,red,red,175650,80
151,black,black,175570,160
152,black,black,175730,10
153,black,black,175740,10
154,red,red,175730,20
155,black,black,175710,40
156,red,red,175670,80
157,red,red,175750,10
158,red,red,175760,10
159,red,red,175770,10
160,green,none,175760,20
161,black,black,175760,20
162,black,black,175780,10
163,red,red,175770,20
164,red,red,175790,10
165,black,black,175780,20
166,red,red,175760,40
167,black,black,175720,80
168,green,none,175640,160
169,black,black,175640,160
170,red,red,175480,320
171,black,black,175160,640
172,black,black,175800,10
173,red,red,175790,20
174,black,black,175770,40
175,red,red,175730,80
176,black,black,175650,160
177,red,red,175490,320
178,black,black,175170,640
179,red,red,174530,1280
180,red,red,175810,10
181,red,red,175820,10
182,red,red,175830,10
183,black,black,175820,20
184,red,red,175800,40
185,black,black,175760,80
186,green,none,175680,160
187,black,black,175680,160
188,red,red,175520,320
189,black,black,175200,640
190,black,black,175840,10
191,red,red,175830,20
192,red,red,175850,10
193,black,black,175840,20
194,black,black,175860,10
195,black,black,175870,10
196,black,black,175880,10
197,black,black,175890,10
198,black,black,175900,10
199,black,black,175910,10
200,black,black,175920,10
201,red,red,175910,20
202,red,red,175930,10
203,green,none,175920,20
204,red,red,175920,20
205,black,black,175900,40
206,black,black,175940,10
207,red,red,175930,20
208,red,red,175950,10
209,black,black,175940,20
210,black,black,175960,10
211,red,red,175950,20
212,red,red,175970,10
213,black,black,175960,20
214,red,red,175940,40
215,black,black,175900,80
216,black,black,175980,10
217,red,red,175970,20
218,red,red,175990,10
219,red,red,176000,10
220,red,red,176010,10
221,red,red,176020,10
222,black,black,176010,20
223,red,red,175990,40
224,black,black,175950,80
225,black,black,176030,10
226,black,black,176040,10
227,red,red,176030,20
228,red,red,176050,10
229,black,black,176040,20
230,red,red,176020,40
231,red,red,176060,10
232,black,black,176050,20
233,black,black,176070,10
234,red,red,176060,20
235,black,black,176040,40
236,black,black,176080,10
237,red,red,176070,20
238,red,red,176090,10
239,red,red,176100,10
240,black,black,176090,20
241,black,black,176110,10
242,red,red,176100,20
243,black,black,176080,40
244,red,red,176040,80
245,black,black,175960,160
246,red,red,175800,320
247,red,red,176120,10
248,black,black,176110,20
249,black,black,176130,10
250,black,black,176140,10
251,black,black,176150,10
252,red,red,176140,20
253,red,red,176160,10
254,red,red,176170,10
255,black,black,176160,20
256,red,red,176140,40
257,red,red,176180,10
258,red,red,176190,10
259,red,red,176200,10
260,black,black,176190,20
261,red,red,176170,40
262,black,black,176130,80
263,red,red,176050,160
264,red,red,176210,10
265,black,black,176200,20
266,red,red,176180,40
267,black,black,176140,80
268,black,black,176220,10
269,red,red,176210,20
270,red,red,176230,10
271,black,black,176220,20
272,black,black,176240,10
273,red,red,176230,20
274,red,red,176250,10
275,red,red,176260,10
276,red,red,176270,10
277,green,none,176260,20
278,black,black,176260,20
279,red,red,176240,40
280,red,red,176280,10
281,red,red,176290,10
282,black,black,176280,20
283,red,red,176260,40
284,red,red,176300,10
285,red,red,176310,10
286,green,none,176300,20
287,red,red,176300,20
288,red,red,176320,10
289,red,red,176330,10
290,black,black,176320,20
291,red,red,176300,40
292,red,red,176340,10
293,red,red,176350,10
294,red,red,176360,10
295,black,black,176350,20
296,red,red,176330,40
297,red,red,176370,10
298,black,black,176360,20
299,red,red,176340,40
300,black,black,176300,80
301,black,black,176380,10
302,red,red,176370,20
303,red,red,176390,10
304,red,red,176400,10
305,black,black,176390,20
306,black,black,176410,10
307,black,black,176420,10
308,black,black,176430,10
309,red,red,176420,20
310,black,black,176400,40
311,black,black,176440,10
312,black,black,176450,10
313,black,black,176460,10
314,black,black,176470,10
315,red,red,176460,20
316,black,black,176440,40
317,black,black,176480,10
318,red,red,176470,20
319,black,black,176450,40
320,black,black,176490,10
321,black,black,176500,10
322,red,red,176490,20
323,black,black,176470,40
324,red,red,176430,80
325,red,red,176510,10
326,red,red,176520,10
327,black,black,176510,20
328,red,red,176490,40
329,black,black,176450,80
330,red,red,176370,160
331,black,black,176210,320
332,red,red,175890,640
333,red,red,176530,10
334,red,red,176540,10
335,red,red,176550,10
336,black,black,176540,20
337,black,black,176560,10
338,red,red,176550,20
339,black,black,176530,40
340,black,black,176570,10
341,red,red,176560,20
342,red,red,176580,10
343,red,red,176590,10
344,red,red,176600,10
345,red,red,176610,10
346,black,black,176600,20
347,red,red,176580,40
348,black,black,176540,80
349,red,red,176460,160
350,red,red,176620,10
351,red,red,176630,10
352,black,black,176620,20
353,red,red,176600,40
354,black,black,176560,80
355,red,red,176480,160
356,red,red,176640,10
357,black,black,176630,20
358,black,black,176650,10
359,red,red,176640,20
360,red,red,176660,10
361,red,red,176670,10
362,red,red,176680,10
363,black,black,176670,20
364,red,red,176650,40
365,black,black,176610,80
366,black,black,176690,10
367,red,red,176680,20
368,red,red,176700,10
369,black,black,176690,20
370,red,red,176670,40
371,red,red,176710,10
372,red,red,176720,10
373,black,black,176710,20
374,black,black,176730,10
375,red,red,176720,20
376,black,black,176700,40
377,red,red,176660,80
378,red,red,176740,10
379,red,red,176750,10
380,black,black,176740,20
381,black,black,176760,10
382,black,black,176770,10
383,black,black,176780,10
384,black,black,176790,10
385,black,black,176800,10
386,red,red,176790,20
387,black,black,176770,40
388,black,black,176810,10
389,red,red,176800,20
390,red,red,176820,10
391,black,black,176810,20
392,black,black,176830,10
393,red,red,176820,20
394,black,black,176800,40
395,red,red,176760,80
396,black,black,176680,160
397,black,black,176840,10
398,black,black,176850,10
399,black,black,176860,10
400,red,red,176850,20
401,black,black,176830,40
402,red,red,176790,80
403,black,black,176710,160
404,black,black,176870,10
405,black,black,176880,10
406,black,black,176890,10
407,black,black,176900,10
408,red,red,176890,20
409,black,black,176870,40
410,black,black,176910,10
411,red,red,176900,20
412,red,red,176920,10
413,red,red,176930,10
414,red,red,176940,10
415,red,red,176950,10
416,black,black,176940,20
417,black,black,176960,10
418,red,red,176950,20
419,red,red,176970,10
420,red,red,176980,10
421,black,black,176970,20
422,black,black,176990,10
423,black,black,177000,10
424,black,black,177010,10
425,red,red,177000,20
426,red,red,177020,10
427,black,black,177010,20
428,red,red,176990,40
429,red,red,177030,10
430,black,black,177020,20
431,red,red,177000,40
432,black,black,176960,80
433,black,black,177040,10
434,red,red,177030,20
435,red,red,177050,10
436,red,red,177060,10
437,red,red,177070,10
438,black,black,177060,20
439,red,red,177040,40
440,black,black,177000,80
441,black,black,177080,10
442,red,red,177070,20
443,red,red,177090,10
444,green,none,177080,20
445,black,black,177080,20
446,black,black,177100,10
447,red,red,177090,20
448,black,black,177070,40
449,green,none,177030,80
450,red,red,177030,80
451,black,black,176950,160
452,red,red,176790,320
453,red,red,177110,10
454,black,black,177100,20
455,black,black,177120,10
456,green,none,177110,20
457,black,black,177110,20
458,black,black,177130,10
459,black,black,177140,10
460,black,black,177150,10
461,red,red,177140,20
462,black,black,177120,40
463,red,red,177080,80
464,black,black,177000,160
465,red,red,176840,320
466,black,black,176520,640
467,red,red,175880,1280
468,black,black,174600,2560
469,green,none,172040,5120
470,black,black,172040,5120
471,black,black,177160,10
472,black,black,177170,10
473,black,black,177180,10
474,red,red,177170,20
475,red,red,177190,10
476,red,red,177200,10
477,green,none,177190,20
478,green,red,177190,20
479,black,black,177190,20
480,black,black,177210,10
481,red,red,177200,20
482,red,red,177220,10
483,black,black,177210,20
484,red,red,177190,40
485,black,black,177150,80
486,red,red,177070,160
487,red,red,177230,10
488,red,red,177240,10
489,red,red,177250,10
490,red,red,177260,10
491,black,black,177250,20
492,black,black,177270,10
493,red,red,177260,20
494,red,red,177280,10
495,red,red,177290,10
496,black,black,177280,20
497,black,black,177300,10
498,black,black,177310,10
499,red,red,177300,20
500,black,black,177280,40
501,black,black,177320,10
502,black,black,177330,10
503,red,red,177320,20
504,black,black,177300,40
505,red,red,177260,80
506,black,black,177180,160
507,black,black,177340,10
508,black,black,177350,10
509,red,red,177340,20
510,red,red,177360,10
511,red,red,177370,10
512,black,black,177360,20
513,black,black,177380,10
514,red,red,177370,20
515,red,red,177390,10
516,black,black,177380,20
517,black,black,177400,10
518,black,black,177410,10
519,black,black,177420,10
520,red,red,177410,20
521,red,red,177430,10
522,black,black,177420,20
523,red,red,177400,40
524,black,black,177360,80
525,black,black,177440,10
526,red,red,177430,20
527,black,black,177410,40
528,red,red,177370,80
529,red,red,177450,10
530,black,black,177440,20
531,red,red,177420,40
532,black,black,177380,80
533,black,black,177460,10
534,black,black,177470,10
535,black,black,177480,10
536,red,red,177470,20
537,black,black,177450,40
538,black,black,177490,10
539,red,red,177480,20
540,black,black,177460,40
541,red,red,177420,80
542,black,black,177340,160
543,red,red,177180,320
544,black,black,176860,640
545,black,black,177500,10
546,red,red,177490,20
547,red,red,177510,10
548,black,black,177500,20
549,black,black,177520,10
550,red,red,177510,20
551,black,black,177490,40
552,red,red,177450,80
553,black,black,177370,160
554,black,black,177530,10
555,black,black,177540,10
556,black,black,177550,10
557,black,black,177560,10
558,black,black,177570,10
559,red,red,177560,20
560,black,black,177540,40
561,red,red,177500,80
562,black,black,177420,160
563,black,black,177580,10
564,red,red,177570,20
565,red,red,177590,10
566,black,black,177580,20
567,black,black,177600,10
568,black,black,177610,10
569,red,red,177600,20
570,green,none,177580,40
571,black,black,177580,40
572,black,black,177620,10
573,red,red,177610,20
574,red,red,177630,10
575,red,red,177640,10
576,black,black,177630,20
577,red,red,177610,40
578,black,black,177570,80
579,black,black,177650,10
580,red,red,177640,20
581,black,black,177620,40
582,black,black,177660,10
583,black,black,177670,10
584,red,red,177660,20
585,red,red,177680,10
586,red,red,177690,10
587,red,red,177700,10
588,black,black,177690,20
589,black,black,177710,10
590,black,black,177720,10
591,black,black,177730,10
592,black,black,177740,10
593,red,red,177730,20
594,red,red,177750,10
595,black,black,177740,20
596,red,red,177720,40
597,black,black,177680,80
598,red,red,177600,160
599,red,red,177760,10
600,black,black,177750,20
601,green,none,177730,40
602,red,red,177730,40
603,black,black,177690,80
604,black,black,177770,10
605,red,red,177760,20
606,black,black,177740,40
607,red,red,177700,80
608,red,red,177780,10
609,black,black,177770,20
610,red,red,177750,40
611,red,red,177790,10
612,black,black,177780,20
613,black,black,177800,10
614,black,black,177810,10
615,black,black,177820,10
616,black,black,177830,10
617,black,black,177840,10
618,red,red,177830,20
619,black,black,177810,40
620,red,red,177770,80
621,red,red,177850,10
622,red,red,177860,10
623,black,black,177850,20
624,green,none,177830,40
625,black,black,177830,40
626,black,black,177870,10
627,red,red,177860,20
628,red,red,177880,10
629,black,black,177870,20
630,green,none,177850,40
631,black,black,177850,40
632,black,black,177890,10
633,black,black,177900,10
634,red,red,177890,20
635,black,black,177870,40
636,black,black,177910,10
637,black,black,177920,10
638,red,red,177910,20
639,black,black,177890,40
640,red,red,177850,80
641,black,black,177770,160
642,red,red,177610,320
643,black,black,177290,640
644,black,black,177930,10
645,red,red,177920,20
646,red,red,177940,10
647,black,black,177930,20
648,black,black,177950,10
649,black,black,177960,10
650,black,black,177970,10
651,green,none,177960,20
652,black,black,177960,20
653,red,red,177940,40
654,black,black,177900,80
655,black,black,177980,10
656,red,red,177970,20
657,red,red,177990,10
658,black,black,177980,20
659,red,red,177960,40
660,black,black,177920,80
661,red,red,177840,160
662,red,red,178000,10
663,red,red,178010,10
664,black,black,178000,20
665,black,black,178020,10
666,black,black,178030,10
667,red,red,178020,20
668,green,none,178000,40
669,red,red,178000,40
670,red,red,178040,10
671,red,red,178050,10
672,red,red,178060,10
673,red,red,178070,10
674,red,red,178080,10
675,red,red,178090,10
676,red,red,178100,10
677,red,red,178110,10
678,black,black,178100,20
679,green,none,178080,40
680,black,black,178080,40
681,black,black,178120,10
682,red,red,178110,20
683,red,red,178130,10
684,red,red,178140,10
685,black,black,178130,20
686,black,black,178150,10
687,black,black,178160,10
688,black,black,178170,10
689,black,black,178180,10
690,black,black,178190,10
691,black,black,178200,10
692,red,red,178190,20
693,black,black,178170,40
694,red,red,178130,80
695,red,red,178210,10
696,black,black,178200,20
697,red,red,178180,40
698,black,black,178140,80
699,black,black,178220,10
700,red,red,178210,20
701,red,red,178230,10
702,black,black,178220,20
703,black,black,178240,10
704,red,red,178230,20
705,black,black,178210,40
706,black,black,178250,10
707,black,black,178260,10
708,black,black,178270,10
709,red,red,178260,20
710,red,red,178280,10
711,red,red,178290,10
712,red,red,178300,10
713,black,black,178290,20
714,black,black,178310,10
715,red,red,178300,20
716,red,red,178320,10
717,black,black,178310,20
718,red,red,178290,40
719,black,black,178250,80
720,black,black,178330,10
721,red,red,178320,20
722,black,black,178300,40
723,red,red,178260,80
724,black,black,178180,160
725,black,black,178340,10
726,black,black,178350,10
727,red,red,178340,20
728,red,red,178360,10
729,red,red,178370,10
730,red,red,178380,10
731,red,red,178390,10
732,red,red,178400,10
733,red,red,178410,10
734,black,black,178400,20
735,red,red,178380,40
736,black,black,178340,80
737,red,red,178260,160
738,black,black,178100,320
739,red,red,177780,640
740,black,black,177140,1280
741,black,black,178420,10
742,black,black,178430,10
743,red,red,178420,20
744,red,red,178440,10
745,black,black,178430,20
746,red,red,178410,40
747,black,black,178370,80
748,black,black,178450,10
749,black,black,178460,10
750,black,black,178470,10
751,black,black,178480,10
752,red,red,178470,20
753,red,red,178490,10
754,black,black,178480,20
755,red,red,178460,40
756,black,black,178420,80
757,red,red,178340,160
758,black,black,178180,320
759,red,red,177860,640
760,red,red,178500,10
761,black,black,178490,20
762,red,red,178470,40
763,red,red,178510,10
764,red,red,178520,10
765,red,red,178530,10
766,black,black,178520,20
767,black,black,178540,10
768,black,black,178550,10
769,red,red,178540,20
770,red,red,178560,10
771,black,black,178550,20
772,red,red,178530,40
773,red,red,178570,10
774,green,none,178560,20
775,red,red,178560,20
776,black,black,178540,40
777,red,red,178500,80
778,green,none,178420,160
779,black,black,178420,160
780,black,black,178580,10
781,red,red,178570,20
782,red,red,178590,10
783,black,black,178580,20
784,black,black,178600,10
785,red,red,178590,20
786,red,red,178610,10
787,black,black,178600,20
788,black,black,178620,10
789,black,black,178630,10
790,black,black,178640,10
791,black,black,178650,10
792,black,black,178660,10
793,black,black,178670,10
794,red,red,178660,20
795,black,black,178640,40
796,black,black,178680,10
797,red,red,178670,20
798,black,black,178650,40
799,red,red,178610,80
800,red,red,178690,10
801,black,black,178680,20
802,red,red,178660,40
803,red,red,178700,10
804,red,red,178710,10
805,red,red,178720,10
806,black,black,178710,20
807,black,black,178730,10
808,red,red,178720,20
809,red,red,178740,10
810,black,black,178730,20
811,black,black,178750,10
812,red,red,178740,20
813,black,black,178720,40
814,red,red,178680,80
815,black,black,178600,160
816,red,red,178440,320
817,red,red,178760,10
818,red,red,178770,10
819,black,black,178760,20
820,red,red,178740,40
821,red,red,178780,10
822,black,black,178770,20
823,red,red,178750,40
824,black,black,178710,80
825,black,black,178790,10
826,red,red,178780,20
827,red,red,178800,10
828,red,red,178810,10
829,black,black,178800,20
830,black,black,178820,10
831,red,red,178810,20
832,red,red,178830,10
833,red,red,178840,10
834,red,red,178850,10
835,black,black,178840,20
836,black,black,178860,10
837,red,red,178850,20
838,red,red,178870,10
839,black,black,178860,20
840,black,black,178880,10
841,red,red,178870,20
842,red,red,178890,10
843,red,red,178900,10
844,black,black,178890,20
845,black,black,178910,10
846,red,red,178900,20
847,red,red,178920,10
848,red,red,178930,10
849,red,red,178940,10
850,black,black,178930,20
851,black,black,178950,10
852,black,black,178960,10
853,black,black,178970,10
854,red,red,178960,20
855,red,red,178980,10
856,black,black,178970,20
857,black,black,178990,10
858,black,black,179000,10
859,red,red,178990,20
860,black,black,178970,40
861,black,black,179010,10
862,black,black,179020,10
863,black,black,179030,10
864,red,red,179020,20
865,red,red,179040,10
866,black,black,179030,20
867,black,black,179050,10
868,black,black,179060,10
869,black,black,179070,10
870,red,red,179060,20
871,red,red,179080,10
872,red,red,179090,10
873,red,red,179100,10
874,black,black,179090,20
875,red,red,179070,40
876,red,red,179110,10
877,black,black,179100,20
878,red,red,179080,40
879,red,red,179120,10
880,black,black,179110,20
881,red,red,179090,40
882,black,black,179050,80
883,black,black,179130,10
884,red,red,179120,20
885,red,red,179140,10
886,black,black,179130,20
887,black,black,179150,10
888,black,black,179160,10
889,red,red,179150,20
890,black,black,179130,40
891,black,black,179170,10
892,red,red,179160,20
893,black,black,179140,40
894,black,black,179180,10
895,black,black,179190,10
896,black,black,179200,10
897,black,black,179210,10
898,black,black,179220,10
899,red,red,179210,20
900,black,black,179190,40
901,black,black,179230,10
902,black,black,179240,10
903,red,red,179230,20
904,red,red,179250,10
905,red,red,179260,10
906,black,black,179250,20
907,red,red,179230,40
908,black,black,179190,80
909,black,black,179270,10
910,black,black,179280,10
911,red,red,179270,20
912,red,red,179290,10
913,red,red,179300,10
914,black,black,179290,20
915,red,red,179270,40
916,red,red,179310,10
917,red,red,179320,10
918,red,red,179330,10
919,black,black,179320,20
920,red,red,179300,40
921,red,red,179340,10
922,black,black,179330,20
923,black,black,179350,10
924,black,black,179360,10
925,red,red,179350,20
926,red,red,179370,10
927,red,red,179380,10
928,black,black,179370,20
929,red,red,179350,40
930,black,black,179310,80
931,red,red,179230,160
932,black,black,179070,320
933,black,black,179390,10
934,red,red,179380,20
935,black,black,179360,40
936,black,black,179400,10
937,black,black,179410,10
938,red,red,179400,20
939,black,black,179380,40
940,black,black,179420,10
941,black,black,179430,10
942,red,red,179420,20
943,red,red,179440,10
944,red,red,179450,10
945,red,red,179460,10
946,red,red,179470,10
947,red,red,179480,10
948,red,red,179490,10
949,red,red,179500,10
950,black,black,179490,20
951,black,black,179510,10
952,black,black,179520,10
953,black,black,179530,10
954,red,red,179520,20
955,red,red,179540,10
956,black,black,179530,20
957,black,black,179550,10
958,red,red,179540,20
959,black,black,179520,40
960,red,red,179480,80
961,black,black,179400,160
962,green,none,179240,320
963,red,red,179240,320
964,red,red,179560,10
965,black,black,179550,20
966,black,black,179570,10
967,red,red,179560,20
968,red,red,179580,10
969,black,black,179570,20
970,black,black,179590,10
971,green,none,179580,20
972,black,black,179580,20
973,red,red,179560,40
974,black,black,179520,80
975,red,red,179440,160
976,red,red,179600,10
977,black,black,179590,20
978,black,black,179610,10
979,red,red,179600,20
980,red,red,179620,10
981,black,black,179610,20
982,black,black,179630,10
983,red,red,179620,20
984,red,red,179640,10
985,black,black,179630,20
986,red,red,179610,40
987,green,none,179570,80
988,red,red,179570,80
989,red,red,179650,10
990,black,black,179640,20
991,red,red,179620,40
992,black,black,179580,80
993,black,black,179660,10
994,red,red,179650,20
995,red,red,179670,10
996,black,black,179660,20
997,black,black,179680,10
998,black,black,179690,10
999,red,red,179680,20
1000,black,black,179660,40
1001,red,red,179620,80
1002,black,black,179540,160
1003,black,black,179700,10
1004,red,red,179690,20
1005,red,red,179710,10
1006,black,black,179700,20
1007,black,black,179720,10
1008,red,red,179710,20
1009,red,red,179730,10
1010,black,black,179720,20
1011,red,red,179700,40
1012,red,red,179740,10
1013,red,red,179750,10
1014,green,none,179740,20
1015,black,black,179740,20
1016,black,black,179760,10
1017,black,black,179770,10
1018,red,red,179760,20
1019,black,black,179740,40
1020,black,black,179780,10
1021,black,black,179790,10
1022,red,red,179780,20
1023,red,red,179800,10
1024,red,red,179810,10
1025,red,red,179820,10
1026,black,black,179810,20
1027,red,red,179790,40
1028,black,black,179750,80
1029,red,red,179670,160
1030,black,black,179510,320
1031,red,red,179190,640
1032,black,black,178550,1280
1033,black,black,179830,10
1034,black,black,179840,10
1035,red,red,179830,20
1036,black,black,179810,40
1037,red,red,179770,80
1038,black,black,179690,160
1039,black,black,179850,10
1040,red,red,179840,20
1041,black,black,179820,40
1042,red,red,179780,80
1043,red,red,179860,10
1044,red,red,179870,10
1045,black,black,179860,20
1046,red,red,179840,40
1047,black,black,179800,80
1048,black,black,179880,10
1049,red,red,179870,20
1050,black,black,179850,40
1051,red,red,179810,80
1052,black,black,179730,160
1053,red,red,179570,320
1054,red,red,179890,10
1055,red,red,179900,10
1056,red,red,179910,10
1057,red,red,179920,10
1058,red,red,179930,10
1059,red,red,179940,10
1060,black,black,179930,20
1061,red,red,179910,40
1062,red,red,179950,10
1063,red,red,179960,10
1064,red,red,179970,10
1065,black,black,179960,20
1066,red,red,179940,40
1067,black,black,179900,80
1068,black,black,179980,10
1069,black,black,179990,10
1070,black,black,180000,10
1071,red,red,179990,20
1072,red,red,180010,10
1073,red,red,180020,10
1074,black,black,180010,20
1075,red,red,179990,40
1076,black,black,179950,80
1077,black,black,180030,10
1078,red,red,180020,20
1079,black,black,180000,40
1080,black,black,180040,10
1081,black,black,180050,10
1082,black,black,180060,10
1083,red,red,180050,20
1084,black,black,180030,40
1085,red,red,179990,80
1086,red,red,180070,10
1087,red,red,180080,10
1088,black,black,180070,20
1089,red,red,180050,40
1090,black,black,180010,80
1091,red,red,179930,160
1092,red,red,180090,10
1093,red,red,180100,10
1094,black,black,180090,20
1095,red,red,180070,40
1096,red,red,180110,10
1097,black,black,180100,20
1098,red,red,180080,40
1099,red,red,180120,10
1100,black,black,180110,20
1101,black,black,180130,10
1102,black,black,180140,10
1103,red,red,180130,20
1104,red,red,180150,10
1105,black,black,180140,20
1106,black,black,180160,10
1107,black,black,180170,10
1108,red,red,180160,20
1109,black,black,180140,40
1110,black,black,180180,10
1111,black,black,180190,10
1112,red,red,180180,20
1113,black,black,180160,40
1114,red,red,180120,80
1115,red,red,180200,10
1116,red,red,180210,10
1117,black,black,180200,20
1118,red,red,180180,40
1119,black,black,180140,80
1120,black,black,180220,10
1121,black,black,180230,10
1122,red,red,180220,20
1123,red,red,180240,10
1124,black,black,180230,20
1125,black,black,180250,10
1126,black,black,180260,10
1127,black,black,180270,10
1128,black,black,180280,10
1129,black,black,180290,10
1130,black,black,180300,10
1131,black,black,180310,10
1132,red,red,180300,20
1133,black,black,180280,40
1134,red,red,180240,80
1135,red,red,180320,10
1136,black,black,180310,20
1137,red,red,180290,40
1138,red,red,180330,10
1139,black,black,180320,20
1140,black,black,180340,10
1141,red,red,180330,20
1142,red,red,180350,10
1143,red,red,180360,10
1144,red,red,180370,10
1145,black,black,180360,20
1146,black,black,180380,10
1147,black,black,180390,10
1148,black,black,180400,10
1149,black,black,180410,10
1150,black,black,180420,10
1151,red,red,180410,20
1152,black,black,180390,40
1153,black,black,180430,10
1154,black,black,180440,10
1155,black,black,180450,10
1156,red,red,180440,20
1157,red,red,180460,10
1158,red,red,180470,10
1159,black,black,180460,20
1160,black,black,180480,10
1161,black,black,180490,10
1162,red,red,180480,20
1163,red,red,180500,10
1164,red,red,180510,10
1165,black,black,180500,20
1166,red,red,180480,40
1167,red,red,180520,10
1168,black,black,180510,20
1169,black,black,180530,10
1170,green,none,180520,20
1171,black,black,180520,20
1172,red,red,180500,40
1173,black,black,180460,80
1174,black,black,180540,10
1175,black,black,180550,10
1176,red,red,180540,20
1177,black,black,180520,40
1178,black,black,180560,10
1179,red,red,180550,20
1180,black,black,180530,40
1181,red,red,180490,80
1182,red,red,180570,10
1183,red,red,180580,10
1184,green,none,180570,20
1185,red,red,180570,20
1186,red,red,180590,10
1187,black,black,180580,20
1188,black,black,180600,10
1189,black,black,180610,10
1190,red,red,180600,20
1191,black,black,180580,40
1192,black,black,180620,10
1193,red,red,180610,20
1194,green,none,180590,40
1195,red,red,180590,40
1196,red,red,180630,10
1197,red,red,180640,10
1198,red,red,180650,10
1199,red,red,180660,10
1200,black,black,180650,20
1201,red,red,180630,40
1202,black,black,180590,80
1203,black,black,180670,10
1204,red,red,180660,20
1205,black,black,180640,40
1206,black,black,180680,10
1207,red,red,180670,20
1208,red,red,180690,10
1209,black,black,180680,20
1210,red,red,180660,40
1211,black,black,180620,80
1212,black,black,180700,10
1213,black,black,180710,10
1214,black,black,180720,10
1215,red,red,180710,20
1216,black,black,180690,40
1217,red,red,180650,80
1218,red,red,180730,10
1219,red,red,180740,10
1220,red,red,180750,10
1221,red,red,180760,10
1222,red,red,180770,10
1223,black,black,180760,20
1224,black,black,180780,10
1225,black,black,180790,10
1226,black,black,180800,10
1227,red,red,180790,20
1228,red,red,180810,10
1229,red,red,180820,10
1230,red,red,180830,10
1231,black,black,180820,20
1232,red,red,180800,40
1233,red,red,180840,10
1234,black,black,180830,20
1235,red,red,180810,40
1236,red,red,180850,10
1237,black,black,180840,20
1238,black,black,180860,10
1239,red,red,180850,20
1240,black,black,180830,40
1241,black,black,180870,10
1242,red,red,180860,20
1243,red,red,180880,10
1244,black,black,180870,20
1245,black,black,180890,10
1246,red,red,180880,20
1247,black,black,180860,40
1248,black,black,180900,10
1249,red,red,180890,20
1250,black,black,180870,40
1251,black,black,180910,10
1252,black,black,180920,10
1253,red,red,180910,20
1254,black,black,180890,40
1255,black,black,180930,10
1256,red,red,180920,20
1257,black,black,180900,40
1258,red,red,180860,80
1259,red,red,180940,10
1260,black,black,180930,20
1261,black,black,180950,10
1262,red,red,180940,20
1263,red,red,180960,10
1264,red,red,180970,10
1265,red,red,180980,10
1266,black,black,180970,20
1267,black,black,180990,10
1268,black,black,181000,10
1269,black,black,181010,10
1270,red,red,181000,20
1271,black,black,180980,40
1272,red,red,180940,80
1273,red,red,181020,10
1274,red,red,181030,10
1275,black,black,181020,20
1276,red,red,181000,40
1277,red,red,181040,10
1278,black,black,181030,20
1279,black,black,181050,10
1280,red,red,181040,20
1281,red,red,181060,10
1282,red,red,181070,10
1283,red,red,181080,10
1284,black,black,181070,20
1285,black,black,181090,10
1286,red,red,181080,20
1287,black,black,181060,40
1288,red,red,181020,80
1289,black,black,180940,160
1290,red,red,180780,320
1291,black,black,180460,640
1292,red,red,179820,1280
1293,black,black,178540,2560
1294,red,red,175980,5120
1295,red,red,181100,10
1296,black,black,181090,20
1297,red,red,181070,40
1298,black,black,181030,80
1299,black,black,181110,10
1300,black,black,181120,10
1301,red,red,181110,20
1302,red,red,181130,10
1303,black,black,181120,20
1304,black,black,181140,10
1305,red,red,181130,20
1306,red,red,181150,10
1307,red,red,181160,10
1308,black,black,181150,20
1309,red,red,181130,40
1310,black,black,181090,80
1311,red,red,181010,160
1312,black,black,180850,320
1313,red,red,180530,640
1314,red,red,181170,10
1315,black,black,181160,20
1316,red,red,181140,40
1317,black,black,181100,80
1318,red,red,181020,160
1319,black,black,180860,320
1320,red,red,180540,640
1321,black,black,179900,1280
1322,black,black,181180,10
1323,red,red,181170,20
1324,red,red,181190,10
1325,red,red,181200,10
1326,red,red,181210,10
1327,red,red,181220,10
1328,red,red,181230,10
1329,black,black,181220,20
1330,red,red,181200,40
1331,green,none,181160,80
1332,black,black,181160,80
1333,black,black,181240,10
1334,black,black,181250,10
1335,red,red,181240,20
1336,black,black,181220,40
1337,red,red,181180,80
1338,black,black,181100,160
1339,black,black,181260,10
1340,black,black,181270,10
1341,red,red,181260,20
1342,red,red,181280,10
1343,red,red,181290,10
1344,red,red,181300,10
1345,black,black,181290,20
1346,red,red,181270,40
1347,red,red,181310,10
1348,red,red,181320,10
1349,black,black,181310,20
1350,black,black,181330,10
1351,black,black,181340,10
1352,black,black,181350,10
1353,black,black,181360,10
1354,black,black,181370,10
1355,black,black,181380,10
1356,red,red,181370,20
1357,black,black,181350,40
1358,black,black,181390,10
1359,black,black,181400,10
1360,black,black,181410,10
1361,red,red,181400,20
1362,red,red,181420,10
1363,black,black,181410,20
1364,red,red,181390,40
1365,black,black,181350,80
1366,black,black,181430,10
1367,black,black,181440,10
1368,black,black,181450,10
1369,red,red,181440,20
1370,black,black,181420,40
1371,red,red,181380,80
1372,red,red,181460,10
1373,red,red,181470,10
1374,black,black,181460,20
1375,black,black,181480,10
1376,red,red,181470,20
1377,black,black,181450,40
1378,black,black,181490,10
1379,red,red,181480,20
1380,green,none,181460,40
1381,red,red,181460,40
1382,red,red,181500,10
1383,black,black,181490,20
1384,black,black,181510,10
1385,red,red,181500,20
1386,black,black,181480,40
1387,black,black,181520,10
1388,black,black,181530,10
1389,black,black,181540,10
1390,red,red,181530,20
1391,black,black,181510,40
1392,black,black,181550,10
1393,red,red,181540,20
1394,black,black,181520,40
1395,red,red,181480,80
1396,green,none,181400,160
1397,black,black,181400,160
1398,black,black,181560,10
1399,black,black,181570,10
1400,red,red,181560,20
1401,black,black,181540,40
1402,black,black,181580,10
1403,black,black,181590,10
1404,red,red,181580,20
1405,black,black,181560,40
1406,red,red,181520,80
1407,black,black,181440,160
1408,red,red,181280,320
1409,black,black,180960,640
1410,red,red,180320,1280
1411,red,red,181600,10
1412,black,black,181590,20
1413,red,red,181570,40
1414,red,red,181610,10
1415,black,black,181600,20
1416,red,red,181580,40
1417,red,red,181620,10
1418,black,black,181610,20
1419,black,black,181630,10
1420,black,black,181640,10
1421,black,black,181650,10
1422,red,red,181640,20
1423,red,red,181660,10
1424,black,black,181650,20
1425,red,red,181630,40
1426,black,black,181590,80
1427,black,black,181670,10
1428,black,black,181680,10
1429,red,red,181670,20
1430,red,red,181690,10
1431,red,red,181700,10
1432,black,black,181690,20
1433,red,red,181670,40
1434,black,black,181630,80
1435,red,red,181550,160
1436,red,red,181710,10
1437,black,black,181700,20
1438,red,red,181680,40
1439,red,red,181720,10
1440,black,black,181710,20
1441,black,black,181730,10
1442,black,black,181740,10
1443,red,red,181730,20
1444,black,black,181710,40
1445,black,black,181750,10
1446,black,black,181760,10
1447,red,red,181750,20
1448,black,black,181730,40
1449,red,red,181690,80
1450,black,black,181610,160
1451,black,black,181770,10
1452,black,black,181780,10
1453,red,red,181770,20
1454,black,black,181750,40
1455,black,black,181790,10
1456,black,black,181800,10
1457,black,black,181810,10
1458,black,black,181820,10
1459,red,red,181810,20
1460,red,red,181830,10
1461,red,red,181840,10
1462,black,black,181830,20
1463,red,red,181810,40
1464,red,red,181850,10
1465,black,black,181840,20
1466,black,black,181860,10
1467,red,red,181850,20
1468,red,red,181870,10
1469,black,black,181860,20
1470,black,black,181880,10
1471,black,black,181890,10
1472,black,black,181900,10
1473,black,black,181910,10
1474,red,red,181900,20
1475,green,none,181880,40
1476,black,black,181880,40
1477,red,red,181840,80
1478,black,black,181760,160
1479,red,red,181600,320
1480,black,black,181280,640
1481,red,red,180640,1280
1482,red,red,181920,10
1483,red,red,181930,10
1484,red,red,181940,10
1485,red,red,181950,10
1486,black,black,181940,20
1487,black,black,181960,10
1488,red,red,181950,20
1489,red,red,181970,10
1490,red,red,181980,10
1491,red,red,181990,10
1492,red,red,182000,10
1493,black,black,181990,20
1494,black,black,182010,10
1495,black,black,182020,10
1496,red,red,182010,20
1497,black,black,181990,40
1498,red,red,181950,80
1499,black,black,181870,160
1500,red,red,181710,320
1501,black,black,181390,640
1502,red,red,180750,1280
1503,black,black,179470,2560
1504,red,red,176910,5120
1505,black,black,171790,10240
1506,black,black,182030,10
1507,red,red,182020,20
1508,black,black,182000,40
1509,black,black,182040,10
1510,black,black,182050,10
1511,red,red,182040,20
1512,black,black,182020,40
1513,black,black,182060,10
1514,black,black,182070,10
1515,red,red,182060,20
1516,black,black,182040,40
1517,red,red,182000,80
1518,black,black,181920,160
1519,black,black,182080,10
1520,red,red,182070,20
1521,black,black,182050,40
1522,black,black,182090,10
1523,black,black,182100,10
1524,red,red,182090,20
1525,black,black,182070,40
1526,black,black,182110,10
1527,black,black,182120,10
1528,red,red,182110,20
1529,red,red,182130,10
1530,black,black,182120,20
1531,black,black,182140,10
1532,green,none,182130,20
1533,red,red,182130,20
1534,red,red,182150,10
1535,red,red,182160,10
1536,black,black,182150,20
1537,black,black,182170,10
1538,red,red,182160,20
1539,black,black,182140,40
1540,red,red,182100,80
1541,green,none,182020,160
1542,red,red,182020,160
1543,black,black,181860,320
1544,red,red,181540,640
1545,black,black,180900,1280
1546,red,red,179620,2560
1547,red,red,182180,10
1548,red,red,182190,10
1549,red,red,182200,10
1550,black,black,182190,20
1551,red,red,182170,40
1552,red,red,182210,10
1553,black,black,182200,20
1554,black,black,182220,10
1555,red,red,182210,20
1556,red,red,182230,10
1557,red,red,182240,10
1558,black,black,182230,20
1559,red,red,182210,40
1560,black,black,182170,80
1561,black,black,182250,10
1562,black,black,182260,10
1563,black,black,182270,10
1564,black,black,182280,10
1565,black,black,182290,10
1566,red,red,182280,20
1567,black,black,182260,40
1568,red,red,182220,80
1569,black,black,182140,160
1570,red,red,181980,320
1571,green,none,181660,640
1572,black,black,181660,640
1573,red,red,181020,1280
1574,black,black,179740,2560
1575,black,black,182300,10
1576,black,black,182310,10
1577,black,black,182320,10
1578,black,black,182330,10
1579,red,red,182320,20
1580,red,red,182340,10
1581,red,red,182350,10
1582,black,black,182340,20
1583,black,black,182360,10
1584,black,black,182370,10
1585,black,black,182380,10
1586,black,black,182390,10
1587,black,black,182400,10
1588,red,red,182390,20
1589,green,none,182370,40
1590,black,black,182370,40
1591,red,red,182330,80
1592,red,red,182410,10
1593,red,red,182420,10
1594,black,black,182410,20
1595,black,black,182430,10
1596,red,red,182420,20
1597,red,red,182440,10
1598,red,red,182450,10
1599,red,red,182460,10
1600,black,black,182450,20
1601,black,black,182470,10
1602,red,red,182460,20
1603,red,red,182480,10
1604,red,red,182490,10
1605,black,black,182480,20
1606,red,red,182460,40
1607,red,red,182500,10
1608,black,black,182490,20
1609,red,red,182470,40
1610,black,black,182430,80
1611,black,black,182510,10
1612,black,black,182520,10
1613,red,red,182510,20
1614,red,red,182530,10
1615,red,red,182540,10
1616,red,red,182550,10
1617,green,none,182540,20
1618,red,red,182540,20
1619,black,black,182520,40
1620,red,red,182480,80
1621,red,red,182560,10
1622,red,red,182570,10
1623,black,black,182560,20
1624,black,black,182580,10
1625,black,black,182590,10
1626,red,red,182580,20
1627,red,red,182600,10
1628,black,black,182590,20
1629,red,red,182570,40
1630,black,black,182530,80
1631,black,black,182610,10
1632,red,red,182600,20
1633,black,black,182580,40
1634,red,red,182540,80
1635,black,black,182460,160
1636,red,red,182300,320
1637,black,black,181980,640
1638,red,red,181340,1280
1639,red,red,182620,10
1640,black,black,182610,20
1641,red,red,182590,40
1642,red,red,182630,10
1643,red,red,182640,10
1644,green,none,182630,20
1645,black,black,182630,20
1646,red,red,182610,40
1647,black,black,182570,80
1648,red,red,182490,160
1649,red,red,182650,10
1650,black,black,182640,20
1651,red,red,182620,40
1652,red,red,182660,10
1653,black,black,182650,20
1654,red,red,182630,40
1655,red,red,182670,10
1656,red,red,182680,10
1657,black,black,182670,20
1658,black,black,182690,10
1659,red,red,182680,20
1660,black,black,182660,40
1661,black,black,182700,10
1662,black,black,182710,10
1663,green,none,182700,20
1664,red,red,182700,20
1665,red,red,182720,10
1666,red,red,182730,10
1667,red,red,182740,10
1668,red,red,182750,10
1669,black,black,182740,20
1670,red,red,182720,40
1671,black,black,182680,80
1672,black,black,182760,10
1673,black,black,182770,10
1674,red,red,182760,20
1675,red,red,182780,10
1676,red,red,182790,10
1677,black,black,182780,20
1678,red,red,182760,40
1679,red,red,182800,10
1680,black,black,182790,20
1681,red,red,182770,40
1682,black,black,182730,80
1683,red,red,182650,160
1684,red,red,182810,10
1685,black,black,182800,20
1686,black,black,182820,10
1687,black,black,182830,10
1688,red,red,182820,20
1689,red,red,182840,10
1690,black,black,182830,20
1691,black,black,182850,10
1692,black,black,182860,10
1693,red,red,182850,20
1694,red,red,182870,10
1695,black,black,182860,20
1696,red,red,182840,40
1697,red,red,182880,10
1698,black,black,182870,20
1699,black,black,182890,10
1700,red,red,182880,20
1701,red,red,182900,10
1702,black,black,182890,20
1703,red,red,182870,40
1704,black,black,182830,80
1705,black,black,182910,10
1706,red,red,182900,20
1707,red,red,182920,10
1708,red,red,182930,10
1709,red,red,182940,10
1710,black,black,182930,20
1711,black,black,182950,10
1712,black,black,182960,10
1713,green,none,182950,20
1714,red,red,182950,20
1715,black,black,182930,40
1716,black,black,182970,10
1717,red,red,182960,20
1718,red,red,182980,10
1719,red,red,182990,10
1720,black,black,182980,20
1721,red,red,182960,40
1722,red,red,183000,10
1723,black,black,182990,20
1724,black,black,183010,10
1725,red,red,183000,20
1726,black,black,182980,40
1727,black,black,183020,10
1728,black,black,183030,10
1729,red,red,183020,20
1730,red,red,183040,10
1731,red,red,183050,10
1732,red,red,183060,10
1733,red,red,183070,10
1734,red,red,183080,10
1735,black,black,183070,20
1736,red,red,183050,40
1737,black,black,183010,80
1738,red,red,182930,160
1739,black,black,182770,320
1740,black,black,183090,10
1741,black,black,183100,10
1742,red,red,183090,20
1743,black,black,183070,40
1744,black,black,183110,10
1745,red,red,183100,20
1746,red,red,183120,10
1747,red,red,183130,10
1748,red,red,183140,10
1749,red,red,183150,10
1750,black,black,183140,20
1751,black,black,183160,10
1752,black,black,183170,10
1753,red,red,183160,20
1754,black,black,183140,40
1755,red,red,183100,80
1756,black,black,183020,160
1757,red,red,182860,320
1758,black,black,182540,640
1759,black,black,183180,10
1760,black,black,183190,10
1761,black,black,183200,10
1762,red,red,183190,20
1763,red,red,183210,10
1764,red,red,183220,10
1765,red,red,183230,10
1766,black,black,183220,20
1767,black,black,183240,10
1768,red,red,183230,20
1769,red,red,183250,10
1770,black,black,183240,20
1771,black,black,183260,10
1772,black,black,183270,10
1773,green,none,183260,20
1774,red,red,183260,20
1775,black,black,183240,40
1776,black,black,183280,10
1777,black,black,183290,10
1778,red,red,183280,20
1779,black,black,183260,40
1780,black,black,183300,10
1781,red,red,183290,20
1782,red,red,183310,10
1783,green,none,183300,20
1784,red,red,183300,20
1785,black,black,183280,40
1786,black,black,183320,10
1787,black,black,183330,10
1788,red,red,183320,20
1789,black,black,183300,40
1790,black,black,183340,10
1791,red,red,183330,20
1792,red,red,183350,10
1793,black,black,183340,20
1794,black,black,183360,10
1795,red,red,183350,20
1796,black,black,183330,40
1797,red,red,183290,80
1798,red,red,183370,10
1799,black,black,183360,20
1800,red,red,183340,40
1801,black,black,183300,80
1802,red,red,183220,160
1803,red,red,183380,10
1804,red,red,183390,10
1805,black,black,183380,20
1806,black,black,183400,10
1807,black,black,183410,10
1808,black,black,183420,10
1809,green,none,183410,20
1810,black,black,183410,20
1811,black,black,183430,10
1812,black,black,183440,10
1813,red,red,183430,20
1814,red,red,183450,10
1815,red,red,183460,10
1816,red,red,183470,10
1817,black,black,183460,20
1818,red,red,183440,40
1819,black,black,183400,80
1820,red,red,183320,160
1821,red,red,183480,10
1822,red,red,183490,10
1823,black,black,183480,20
1824,black,black,183500,10
1825,red,red,183490,20
1826,black,black,183470,40
1827,red,red,183430,80
1828,black,black,183350,160
1829,red,red,183190,320
1830,black,black,182870,640
1831,red,red,182230,1280
1832,red,red,183510,10
1833,black,black,183500,20
1834,black,black,183520,10
1835,red,red,183510,20
1836,red,red,183530,10
1837,red,red,183540,10
1838,red,red,183550,10
1839,red,red,183560,10
1840,red,red,183570,10
1841,black,black,183560,20
1842,red,red,183540,40
1843,black,black,183500,80
1844,black,black,183580,10
1845,red,red,183570,20
1846,red,red,183590,10
1847,red,red,183600,10
1848,black,black,183590,20
1849,red,red,183570,40
1850,black,black,183530,80
1851,black,black,183610,10
1852,black,black,183620,10
1853,black,black,183630,10
1854,black,black,183640,10
1855,red,red,183630,20
1856,red,red,183650,10
1857,black,black,183640,20
1858,black,black,183660,10
1859,black,black,183670,10
1860,black,black,183680,10
1861,green,none,183670,20
1862,red,red,183670,20
1863,black,black,183650,40
1864,black,black,183690,10
1865,red,red,183680,20
1866,black,black,183660,40
1867,red,red,183620,80
1868,black,black,183540,160
1869,black,black,183700,10
1870,black,black,183710,10
1871,black,black,183720,10
1872,red,red,183710,20
1873,black,black,183690,40
1874,black,black,183730,10
1875,red,red,183720,20
1876,black,black,183700,40
1877,red,red,183660,80
1878,black,black,183580,160
1879,red,red,183420,320
1880,red,red,183740,10
1881,black,black,183730,20
1882,black,black,183750,10
1883,red,red,183740,20
1884,red,red,183760,10
1885,black,black,183750,20
1886,red,red,183730,40
1887,red,red,183770,10
1888,red,red,183780,10
1889,red,red,183790,10
1890,red,red,183800,10
1891,black,black,183790,20
1892,black,black,183810,10
1893,red,red,183800,20
1894,black,black,183780,40
1895,red,red,183740,80
1896,red,red,183820,10
1897,black,black,183810,20
1898,black,black,183830,10
1899,red,red,183820,20
1900,red,red,183840,10
1901,red,red,183850,10
1902,red,red,183860,10
1903,red,red,183870,10
1904,green,none,183860,20
1905,black,black,183860,20
1906,red,red,183840,40
1907,red,red,183880,10
1908,black,black,183870,20
1909,red,red,183850,40
1910,red,red,183890,10
1911,black,black,183880,20
1912,black,black,183900,10
1913,black,black,183910,10
1914,black,black,183920,10
1915,black,black,183930,10
1916,red,red,183920,20
1917,black,black,183900,40
1918,black,black,183940,10
1919,red,red,183930,20
1920,red,red,183950,10
1921,red,red,183960,10
1922,black,black,183950,20
1923,black,black,183970,10
1924,black,black,183980,10
1925,black,black,183990,10
1926,black,black,184000,10
1927,black,black,184010,10
1928,red,red,184000,20
1929,black,black,183980,40
1930,black,black,184020,10
1931,red,red,184010,20
1932,red,red,184030,10
1933,black,black,184020,20
1934,red,red,184000,40
1935,black,black,183960,80
1936,red,red,183880,160
1937,red,red,184040,10
1938,black,black,184030,20
1939,red,red,184010,40
1940,red,red,184050,10
1941,red,red,184060,10
1942,black,black,184050,20
1943,black,black,184070,10
1944,black,black,184080,10
1945,red,red,184070,20
1946,black,black,184050,40
1947,red,red,184010,80
1948,black,black,183930,160
1949,red,red,183770,320
1950,black,black,183450,640
1951,red,red,182810,1280
1952,black,black,181530,2560
1953,red,red,178970,5120
1954,red,red,184090,10
1955,red,red,184100,10
1956,black,black,184090,20
1957,red,red,184070,40
1958,red,red,184110,10
1959,red,red,184120,10
1960,red,red,184130,10
1961,black,black,184120,20
1962,red,red,184100,40
1963,red,red,184140,10
1964,black,black,184130,20
1965,black,black,184150,10
1966,red,red,184140,20
1967,black,black,184120,40
1968,black,black,184160,10
1969,red,red,184150,20
1970,red,red,184170,10
1971,black,black,184160,20
1972,black,black,184180,10
1973,black,black,184190,10
1974,black,black,184200,10
1975,red,red,184190,20
1976,black,black,184170,40
1977,black,black,184210,10
1978,red,red,184200,20
1979,black,black,184180,40
1980,red,red,184140,80
1981,red,red,184220,10
1982,black,black,184210,20
1983,red,red,184190,40
1984,red,red,184230,10
1985,red,red,184240,10
1986,red,red,184250,10
1987,red,red,184260,10
1988,black,black,184250,20
1989,red,red,184230,40
1990,black,black,184190,80
1991,black,black,184270,10
1992,red,red,184260,20
1993,red,red,184280,10
1994,red,red,184290,10
1995,red,red,184300,10
1996,red,red,184310,10
1997,green,none,184300,20
1998,red,red,184300,20
1999,black,black,184280,40
2000,black,black,184320,10
2001,black,black,184330,10
2002,red,red,184320,20
2003,red,red,184340,10
2004,black,black,184330,20
2005,black,black,184350,10
2006,red,red,184340,20
2007,red,red,184360,10
2008,black,black,184350,20
2009,black,black,184370,10
2010,black,black,184380,10
2011,red,red,184370,20
2012,red,red,184390,10
2013,black,black,184380,20
2014,red,red,184360,40
2015,red,red,184400,10
2016,red,red,184410,10
2017,red,red,184420,10
2018,black,black,184410,20
2019,red,red,184390,40
2020,red,red,184430,10
2021,red,red,184440,10
2022,red,red,184450,10
2023,red,red,184460,10
2024,red,red,184470,10
2025,red,red,184480,10
2026,red,red,184490,10
2027,black,black,184480,20
2028,red,red,184460,40
2029,red,red,184500,10
2030,red,red,184510,10
2031,black,black,184500,20
2032,black,black,184520,10
2033,black,black,184530,10
2034,black,black,184540,10
2035,black,black,184550,10
2036,black,black,184560,10
2037,red,red,184550,20
2038,green,none,184530,40
2039,red,red,184530,40
2040,red,red,184570,10
2041,black,black,184560,20
2042,red,red,184540,40
2043,red,red,184580,10
2044,red,red,184590,10
2045,black,black,184580,20
2046,black,black,184600,10
2047,red,red,184590,20
2048,black,black,184570,40
2049,black,black,184610,10
2050,red,red,184600,20
2051,black,black,184580,40
2052,red,red,184540,80
2053,red,red,184620,10
2054,red,red,184630,10
2055,red,red,184640,10
2056,green,none,184630,20
2057,red,red,184630,20
2058,red,red,184650,10
2059,black,black,184640,20
2060,red,red,184620,40
2061,black,black,184580,80
2062,red,red,184500,160
2063,black,black,184340,320
2064,red,red,184020,640
2065,red,red,184660,10
2066,red,red,184670,10
2067,black,black,184660,20
2068,black,black,184680,10
2069,red,red,184670,20
2070,red,red,184690,10
2071,black,black,184680,20
2072,black,black,184700,10
2073,red,red,184690,20
2074,black,black,184670,40
2075,red,red,184630,80
2076,black,black,184550,160
2077,red,red,184390,320
2078,red,red,184710,10
2079,black,black,184700,20
2080,black,black,184720,10
2081,red,red,184710,20
2082,black,black,184690,40
2083,green,none,184650,80
2084,red,red,184650,80
2085,black,black,184570,160
2086,red,red,184410,320
2087,black,black,184090,640
2088,red,red,183450,1280
2089,black,black,182170,2560
2090,red,red,179610,5120
2091,red,red,184730,10
2092,green,none,184720,20
2093,black,black,184720,20
2094,black,black,184740,10
2095,red,red,184730,20
2096,red,red,184750,10
2097,red,red,184760,10
2098,red,red,184770,10
2099,black,black,184760,20
2100,red,red,184740,40
2101,black,black,184700,80
2102,black,black,184780,10
2103,black,black,184790,10
2104,red,red,184780,20
2105,red,red,184800,10
2106,black,black,184790,20
2107,black,black,184810,10
2108,black,black,184820,10
2109,red,red,184810,20
2110,black,black,184790,40
2111,red,red,184750,80
2112,black,black,184670,160
2113,black,black,184830,10
2114,black,black,184840,10
2115,red,red,184830,20
2116,black,black,184810,40
2117,red,red,184770,80
2118,red,red,184850,10
2119,black,black,184840,20
2120,red,red,184820,40
2121,red,red,184860,10
2122,black,black,184850,20
2123,red,red,184830,40
2124,red,red,184870,10
2125,black,black,184860,20
2126,black,black,184880,10
2127,black,black,184890,10
2128,red,red,184880,20
2129,black,black,184860,40
2130,red,red,184820,80
2131,black,black,184740,160
2132,red,red,184580,320
2133,red,red,184900,10
2134,red,red,184910,10
2135,black,black,184900,20
2136,red,red,184880,40
2137,red,red,184920,10
2138,black,black,184910,20
2139,red,red,184890,40
2140,green,none,184850,80
2141,black,black,184850,80
2142,black,black,184930,10
2143,black,black,184940,10
2144,black,black,184950,10
2145,black,black,184960,10
2146,black,black,184970,10
2147,red,red,184960,20
2148,red,red,184980,10
2149,black,black,184970,20
2150,red,red,184950,40
2151,red,red,184990,10
2152,red,red,185000,10
2153,red,red,185010,10
2154,black,black,185000,20
2155,black,black,185020,10
2156,black,black,185030,10
2157,red,red,185020,20
2158,black,black,185000,40
2159,black,black,185040,10
2160,green,none,185030,20
2161,black,black,185030,20
2162,red,red,185010,40
2163,black,black,184970,80
2164,red,red,184890,160
2165,black,black,184730,320
2166,black,black,185050,10
2167,red,red,185040,20
2168,black,black,185020,40
2169,black,black,185060,10
2170,black,black,185070,10
2171,black,black,185080,10
2172,black,black,185090,10
2173,red,red,185080,20
2174,black,black,185060,40
2175,black,black,185100,10
2176,red,red,185090,20
2177,red,red,185110,10
2178,red,red,185120,10
2179,black,black,185110,20
2180,black,black,185130,10
2181,black,black,185140,10
2182,red,red,185130,20
2183,red,red,185150,10
2184,red,red,185160,10
2185,black,black,185150,20
2186,red,red,185130,40
2187,red,red,185170,10
2188,red,red,185180,10
2189,black,black,185170,20
2190,red,red,185150,40
2191,black,black,185110,80
2192,red,red,185030,160
2193,red,red,185190,10
2194,black,black,185180,20
2195,red,red,185160,40
2196,black,black,185120,80
2197,red,red,185040,160
2198,black,black,184880,320
2199,black,black,185200,10
2200,red,red,185190,20
2201,black,black,185170,40
2202,black,black,185210,10
2203,black,black,185220,10
2204,black,black,185230,10
2205,red,red,185220,20
2206,black,black,185200,40
2207,black,black,185240,10
2208,black,black,185250,10
2209,red,red,185240,20
2210,black,black,185220,40
2211,black,black,185260,10
2212,red,red,185250,20
2213,red,red,185270,10
2214,black,black,185260,20
2215,black,black,185280,10
2216,black,black,185290,10
2217,black,black,185300,10
2218,black,black,185310,10
2219,red,red,185300,20
2220,red,red,185320,10
2221,black,black,185310,20
2222,red,red,185290,40
2223,red,red,185330,10
2224,red,red,185340,10
2225,black,black,185330,20
2226,black,black,185350,10
2227,red,red,185340,20
2228,red,red,185360,10
2229,black,black,185350,20
2230,black,black,185370,10
2231,red,red,185360,20
2232,black,black,185340,40
2233,red,red,185300,80
2234,red,red,185380,10
2235,red,red,185390,10
2236,red,red,185400,10
2237,red,red,185410,10
2238,black,black,185400,20
2239,red,red,185380,40
2240,red,red,185420,10
2241,black,black,185410,20
2242,red,red,185390,40
2243,red,red,185430,10
2244,red,red,185440,10
2245,black,black,185430,20
2246,red,red,185410,40
2247,black,black,185370,80
2248,red,red,185290,160
2249,red,red,185450,10
2250,red,red,185460,10
2251,red,red,185470,10
2252,red,red,185480,10
2253,black,black,185470,20
2254,black,black,185490,10
2255,red,red,185480,20
2256,red,red,185500,10
2257,red,red,185510,10
2258,red,red,185520,10
2259,black,black,185510,20
2260,black,black,185530,10
2261,black,black,185540,10
2262,black,black,185550,10
2263,red,red,185540,20
2264,black,black,185520,40
2265,red,red,185480,80
2266,red,red,185560,10
2267,green,none,185550,20
2268,red,red,185550,20
2269,black,black,185530,40
2270,black,black,185570,10
2271,red,red,185560,20
2272,black,black,185540,40
2273,red,red,185500,80
2274,green,none,185420,160
2275,red,red,185420,160
2276,black,black,185260,320
2277,red,red,184940,640
2278,black,black,184300,1280
2279,red,red,183020,2560
2280,black,black,180460,5120
2281,red,red,175340,10240
2282,red,red,185580,10
2283,black,black,185570,20
2284,black,black,185590,10
2285,red,red,185580,20
2286,black,black,185560,40
2287,black,black,185600,10
2288,black,black,185610,10
2289,black,black,185620,10
2290,red,red,185610,20
2291,red,red,185630,10
2292,red,red,185640,10
2293,red,red,185650,10
2294,black,black,185640,20
2295,black,black,185660,10
2296,black,black,185670,10
2297,black,black,185680,10
2298,red,red,185670,20
2299,black,black,185650,40
2300,red,red,185610,80
2301,red,red,185690,10
2302,black,black,185680,20
2303,red,red,185660,40
2304,red,red,185700,10
2305,red,red,185710,10
2306,black,black,185700,20
2307,black,black,185720,10
2308,black,black,185730,10
2309,black,black,185740,10
2310,red,red,185730,20
2311,black,black,185710,40
2312,black,black,185750,10
2313,red,red,185740,20
2314,black,black,185720,40
2315,red,red,185680,80
2316,black,black,185600,160
2317,green,none,185440,320
2318,black,black,185440,320
2319,red,red,185120,640
2320,black,black,184480,1280
2321,green,none,183200,2560
2322,black,black,183200,2560
2323,red,red,180640,5120
2324,black,black,175520,10240
2325,red,red,165280,20480
2326,red,red,185760,10
2327,black,black,185750,20
2328,black,black,185770,10
2329,red,red,185760,20
2330,black,black,185740,40
2331,red,red,185700,80
2332,red,red,185780,10
2333,red,red,185790,10
2334,red,red,185800,10
2335,red,red,185810,10
2336,black,black,185800,20
2337,red,red,185780,40
2338,black,black,185740,80
2339,red,red,185660,160
2340,green,none,185500,320
2341,red,red,185500,320
2342,red,red,185820,10
2343,black,black,185810,20
2344,black,black,185830,10
2345,red,red,185820,20
2346,red,red,185840,10
2347,red,red,185850,10
2348,red,red,185860,10
2349,red,red,185870,10
2350,black,black,185860,20
2351,red,red,185840,40
2352,red,red,185880,10
2353,black,black,185870,20
2354,black,black,185890,10
2355,green,none,185880,20
2356,black,black,185880,20
2357,red,red,185860,40
2358,black,black,185820,80
2359,black,black,185900,10
2360,red,red,185890,20
2361,green,none,185870,40
2362,black,black,185870,40
2363,red,red,185830,80
2364,black,black,185750,160
2365,black,black,185910,10
2366,red,red,185900,20
2367,black,black,185880,40
2368,red,red,185840,80
2369,black,black,185760,160
2370,red,red,185600,320
2371,black,black,185280,640
2372,black,black,185920,10
2373,black,black,185930,10
2374,red,red,185920,20
2375,red,red,185940,10
2376,red,red,185950,10
2377,black,black,185940,20
2378,red,red,185920,40
2379,black,black,185880,80
2380,black,black,185960,10
2381,black,black,185970,10
2382,red,red,185960,20
2383,red,red,185980,10
2384,red,red,185990,10
2385,red,red,186000,10
2386,red,red,186010,10
2387,black,black,186000,20
2388,red,red,185980,40
2389,red,red,186020,10
2390,black,black,186010,20
2391,black,black,186030,10
2392,red,red,186020,20
2393,red,red,186040,10
2394,red,red,186050,10
2395,black,black,186040,20
2396,black,black,186060,10
2397,red,red,186050,20
2398,red,red,186070,10
2399,red,red,186080,10
2400,black,black,186070,20
2401,red,red,186050,40
2402,black,black,186010,80
2403,black,black,186090,10
2404,red,red,186080,20
2405,red,red,186100,10
2406,black,black,186090,20
2407,black,black,186110,10
2408,red,red,186100,20
2409,black,black,186080,40
2410,red,red,186040,80
2411,red,red,186120,10
2412,red,red,186130,10
2413,red,red,186140,10
2414,green,none,186130,20
2415,black,black,186130,20
2416,black,black,186150,10
2417,red,red,186140,20
2418,red,red,186160,10
2419,red,red,186170,10
2420,black,black,186160,20
2421,red,red,186140,40
2422,red,red,186180,10
2423,green,none,186170,20
2424,red,red,186170,20
2425,red,red,186190,10
2426,red,red,186200,10
2427,black,black,186190,20
2428,red,red,186170,40
2429,red,red,186210,10
2430,red,red,186220,10
2431,black,black,186210,20
2432,red,red,186190,40
2433,black,black,186150,80
2434,red,red,186070,160
2435,red,red,186230,10
2436,red,red,186240,10
2437,black,black,186230,20
2438,black,black,186250,10
2439,green,none,186240,20
2440,black,black,186240,20
2441,red,red,186220,40
2442,black,black,186180,80
2443,red,red,186100,160
2444,red,red,186260,10
2445,red,red,186270,10
2446,black,black,186260,20
2447,red,red,186240,40
2448,black,black,186200,80
2449,red,red,186120,160
2450,red,red,186280,10
2451,black,black,186270,20
2452,red,red,186250,40
2453,black,black,186210,80
2454,red,red,186130,160
2455,red,red,186290,10
2456,red,red,186300,10
2457,black,black,186290,20
2458,red,red,186270,40
2459,black,black,186230,80
2460,red,red,186150,160
2461,black,black,185990,320
2462,red,red,185670,640
2463,black,black,185030,1280
2464,red,red,183750,2560
2465,black,black,181190,5120
2466,red,red,176070,10240
2467,red,red,186310,10
2468,black,black,186300,20
2469,red,red,186280,40
2470,black,black,186240,80
2471,red,red,186160,160
2472,red,red,186320,10
2473,black,black,186310,20
2474,black,black,186330,10
2475,black,black,186340,10
2476,black,black,186350,10
2477,red,red,186340,20
2478,red,red,186360,10
2479,red,red,186370,10
2480,red,red,186380,10
2481,black,black,186370,20
2482,black,black,186390,10
2483,black,black,186400,10
2484,red,red,186390,20
2485,red,red,186410,10
2486,red,red,186420,10
2487,black,black,186410,20
2488,red,red,186390,40
2489,red,red,186430,10
2490,black,black,186420,20
2491,red,red,186400,40
2492,green,none,186360,80
2493,red,red,186360,80
2494,black,black,186280,160
2495,red,red,186120,320
2496,red,red,186440,10
2497,red,red,186450,10
2498,red,red,186460,10
2499,red,red,186470,10
2500,black,black,186460,20
2501,red,red,186440,40
2502,black,black,186400,80
2503,red,red,186320,160
2504,red,red,186480,10
2505,red,red,186490,10
2506,black,black,186480,20
2507,black,black,186500,10
2508,red,red,186490,20
2509,red,red,186510,10
2510,black,black,186500,20
2511,black,black,186520,10
2512,red,red,186510,20
2513,black,black,186490,40
2514,red,red,186450,80
2515,red,red,186530,10
2516,black,black,186520,20
2517,black,black,186540,10
2518,black,black,186550,10
2519,black,black,186560,10
2520,red,red,186550,20
2521,black,black,186530,40
2522,black,black,186570,10
2523,black,black,186580,10
2524,red,red,186570,20
2525,red,red,186590,10
2526,black,black,186580,20
2527,red,red,186560,40
2528,red,red,186600,10
2529,red,red,186610,10
2530,black,black,186600,20
2531,black,black,186620,10
2532,black,black,186630,10
2533,red,red,186620,20
2534,red,red,186640,10
2535,red,red,186650,10
2536,black,black,186640,20
2537,red,red,186620,40
2538,black,black,186580,80
2539,black,black,186660,10
2540,black,black,186670,10
2541,red,red,186660,20
2542,black,black,186640,40
2543,black,black,186680,10
2544,green,none,186670,20
2545,red,red,186670,20
2546,black,black,186650,40
2547,red,red,186610,80
2548,red,red,186690,10
2549,red,red,186700,10
2550,red,red,186710,10
2551,black,black,186700,20
2552,black,black,186720,10
2553,black,black,186730,10
2554,red,red,186720,20
2555,red,red,186740,10
2556,red,red,186750,10
2557,red,red,186760,10
2558,black,black,186750,20
2559,red,red,186730,40
2560,red,red,186770,10
2561,black,black,186760,20
2562,red,red,186740,40
2563,red,red,186780,10
2564,red,red,186790,10
2565,black,black,186780,20
2566,black,black,186800,10
2567,red,red,186790,20
2568,red,red,186810,10
2569,black,black,186800,20
2570,black,black,186820,10
2571,black,black,186830,10
2572,black,black,186840,10
2573,red,red,186830,20
2574,black,black,186810,40
2575,red,red,186770,80
2576,red,red,186850,10
2577,black,black,186840,20
2578,red,red,186820,40
2579,black,black,186780,80
2580,black,black,186860,10
2581,black,black,186870,10
2582,black,black,186880,10
2583,red,red,186870,20
2584,black,black,186850,40
2585,black,black,186890,10
2586,black,black,186900,10
2587,red,red,186890,20
2588,red,red,186910,10
2589,black,black,186900,20
2590,black,black,186920,10
2591,black,black,186930,10
2592,red,red,186920,20
2593,black,black,186900,40
2594,black,black,186940,10
2595,red,red,186930,20
2596,black,black,186910,40
2597,black,black,186950,10
2598,red,red,186940,20
2599,red,red,186960,10
2600,red,red,186970,10
2601,black,black,186960,20
2602,red,red,186940,40
2603,red,red,186980,10
2604,black,black,186970,20
2605,red,red,186950,40
2606,black,black,186910,80
2607,red,red,186830,160
2608,black,black,186670,320
2609,red,red,186350,640
2610,black,black,185710,1280
2611,red,red,184430,2560
2612,black,black,181870,5120
2613,red,red,176750,10240
2614,black,black,166510,20480
2615,red,red,146030,40960
2616,black,black,105070,81920
2617,red,red,23150,163840
2618,red,red,186990,10
2619,red,red,187000,10
2620,black,black,186990,20
2621,black,black,187010,10
2622,black,black,187020,10
2623,red,red,187010,20
2624,black,black,186990,40
2625,red,red,186950,80
2626,red,red,187030,10
2627,black,black,187020,20
2628,red,red,187000,40
2629,red,red,187040,10
2630,red,red,187050,10
2631,red,red,187060,10
2632,red,red,187070,10
2633,black,black,187060,20
2634,red,red,187040,40
2635,red,red,187080,10
2636,red,red,187090,10
2637,red,red,187100,10
2638,red,red,187110,10
2639,red,red,187120,10
2640,black,black,187110,20
2641,red,red,187090,40
2642,red,red,187130,10
2643,red,red,187140,10
2644,red,red,187150,10
2645,black,black,187140,20
2646,black,black,187160,10
2647,black,black,187170,10
2648,red,red,187160,20
2649,black,black,187140,40
2650,black,black,187180,10
2651,red,red,187170,20
2652,black,black,187150,40
2653,red,red,187110,80
2654,red,red,187190,10
2655,black,black,187180,20
2656,red,red,187160,40
2657,black,black,187120,80
2658,black,black,187200,10
2659,red,red,187190,20
2660,black,black,187170,40
2661,red,red,187130,80
2662,black,black,187050,160
2663,black,black,187210,10
2664,red,red,187200,20
2665,red,red,187220,10
2666,red,red,187230,10
2667,black,black,187220,20
2668,black,black,187240,10
2669,black,black,187250,10
2670,red,red,187240,20
2671,red,red,187260,10
2672,black,black,187250,20
2673,red,red,187230,40
2674,red,red,187270,10
2675,black,black,187260,20
2676,red,red,187240,40
2677,red,red,187280,10
2678,black,black,187270,20
2679,red,red,187250,40
2680,red,red,187290,10
2681,red,red,187300,10
2682,black,black,187290,20
2683,red,red,187270,40
2684,red,red,187310,10
2685,black,black,187300,20
2686,red,red,187280,40
2687,black,black,187240,80
2688,red,red,187160,160
2689,black,black,187000,320
2690,red,red,186680,640
2691,red,red,187320,10
2692,black,black,187310,20
2693,black,black,187330,10
2694,red,red,187320,20
2695,black,black,187300,40
2696,red,red,187260,80
2697,black,black,187180,160
2698,black,black,187340,10
2699,red,red,187330,20
2700,red,red,187350,10
2701,red,red,187360,10
2702,black,black,187350,20
2703,red,red,187330,40
2704,black,black,187290,80
2705,black,black,187370,10
2706,black,black,187380,10
2707,black,black,187390,10
2708,red,red,187380,20
2709,black,black,187360,40
2710,black,black,187400,10
2711,red,red,187390,20
2712,black,black,187370,40
2713,black,black,187410,10
2714,red,red,187400,20
2715,black,black,187380,40
2716,black,black,187420,10
2717,red,red,187410,20
2718,red,red,187430,10
2719,red,red,187440,10
2720,red,red,187450,10
2721,black,black,187440,20
2722,black,black,187460,10
2723,red,red,187450,20
2724,red,red,187470,10
2725,red,red,187480,10
2726,black,black,187470,20
2727,black,black,187490,10
2728,red,red,187480,20
2729,red,red,187500,10
2730,red,red,187510,10
2731,black,black,187500,20
2732,black,black,187520,10
2733,black,black,187530,10
2734,black,black,187540,10
2735,green,none,187530,20
2736,black,black,187530,20
2737,black,black,187550,10
2738,black,black,187560,10
2739,red,red,187550,20
2740,black,black,187530,40
2741,black,black,187570,10
2742,black,black,187580,10
2743,red,red,187570,20
2744,black,black,187550,40
2745,black,black,187590,10
2746,red,red,187580,20
2747,green,none,187560,40
2748,red,red,187560,40
2749,red,red,187600,10
2750,black,black,187590,20
2751,black,black,187610,10
2752,black,black,187620,10
2753,red,red,187610,20
2754,red,red,187630,10
2755,black,black,187620,20
2756,black,black,187640,10
2757,red,red,187630,20
2758,black,black,187610,40
2759,black,black,187650,10
2760,red,red,187640,20
2761,red,red,187660,10
2762,red,red,187670,10
2763,black,black,187660,20
2764,red,red,187640,40
2765,red,red,187680,10
2766,red,red,187690,10
2767,black,black,187680,20
2768,black,black,187700,10
2769,black,black,187710,10
2770,red,red,187700,20
2771,black,black,187680,40
2772,red,red,187640,80
2773,red,red,187720,10
2774,red,red,187730,10
2775,red,red,187740,10
2776,red,red,187750,10
2777,black,black,187740,20
2778,black,black,187760,10
2779,black,black,187770,10
2780,red,red,187760,20
2781,black,black,187740,40
2782,black,black,187780,10
2783,black,black,187790,10
2784,black,black,187800,10
2785,black,black,187810,10
2786,red,red,187800,20
2787,red,red,187820,10
2788,red,red,187830,10
2789,black,black,187820,20
2790,red,red,187800,40
2791,red,red,187840,10
2792,black,black,187830,20
2793,black,black,187850,10
2794,black,black,187860,10
2795,red,red,187850,20
2796,black,black,187830,40
2797,red,red,187790,80
2798,red,red,187870,10
2799,red,red,187880,10
2800,red,red,187890,10
2801,black,black,187880,20
2802,green,none,187860,40
2803,black,black,187860,40
2804,black,black,187900,10
2805,red,red,187890,20
2806,black,black,187870,40
2807,red,red,187830,80
2808,red,red,187910,10
2809,red,red,187920,10
2810,red,red,187930,10
2811,black,black,187920,20
2812,black,black,187940,10
2813,red,red,187930,20
2814,red,red,187950,10
2815,red,red,187960,10
2816,red,red,187970,10
2817,black,black,187960,20
2818,red,red,187940,40
2819,black,black,187900,80
2820,black,black,187980,10
2821,black,black,187990,10
2822,red,red,187980,20
2823,black,black,187960,40
2824,black,black,188000,10
2825,black,black,188010,10
2826,red,red,188000,20
2827,red,red,188020,10
2828,black,black,188010,20
2829,black,black,188030,10
2830,red,red,188020,20
2831,red,red,188040,10
2832,red,red,188050,10
2833,green,none,188040,20
2834,black,black,188040,20
2835,green,none,188020,40
2836,red,red,188020,40
2837,red,red,188060,10
2838,black,black,188050,20
2839,black,black,188070,10
2840,black,black,188080,10
2841,black,black,188090,10
2842,black,black,188100,10
2843,red,red,188090,20
2844,black,black,188070,40
2845,red,red,188030,80
2846,black,black,187950,160
2847,black,black,188110,10
2848,red,red,188100,20
2849,black,black,188080,40
2850,black,black,188120,10
2851,green,none,188110,20
2852,black,black,188110,20
2853,red,red,188090,40
2854,black,black,188050,80
2855,black,black,188130,10
2856,red,red,188120,20
2857,black,black,188100,40
2858,green,none,188060,80
2859,red,red,188060,80
2860,black,black,187980,160
2861,black,black,188140,10
2862,red,red,188130,20
2863,black,black,188110,40
2864,red,red,188070,80
2865,red,red,188150,10
2866,black,black,188140,20
2867,black,black,188160,10
2868,red,red,188150,20
2869,red,red,188170,10
2870,black,black,188160,20
2871,red,red,188140,40
2872,red,red,188180,10
